100 Calorie Packs Chips Ahoy! Cookies Snacks
100 Calorie Packs Lorna Doone Shortbread Cookie Crisps	Snacks
100 Calorie Snack Packs Variety	Snacks
100% Colombian Ground Coffee Med-Dark	Beverages
3 Musketeers Bar	Candy
4C Ice Tea Mix Peach	Beverages
4C Ice Tea Mix Raspberry	Beverages
4C Iced Tea Light Decaff With Lemon	Beverages
4C Iced Tea Mix Decaf Natural Lemon	Beverages
4C Red With Peach Ice Tea Mix	Beverages
8 in 1 FerretBites Peanut Butter Crunch for Ferrets	Pet Food
Academia Barilla Pinzimonio Kit	Pantry & Condiments
Ah Alska Baker's Cocoa	Baking Supplies
Ah!laska Organic Cocoa	Baking Supplies
Airforce Nutrisoda Calm Wild Berry & Citron	Beverages
Airforce Nutrisoda Energize Mandarin & Mint	Beverages
Airforce Nutrisoda Energize Mandarin Mint	Snacks
Airforce Nutrisoda Flex Black Cherry & Apple	Beverages
Airforce Nutrisoda Radiant Pomegranate & Blackberry	Beverages
Airforce Nutrisoda Renew Watermelon & Blueberry	Beverages
Airforce Nutrisoda Slender Sparkling Pink Grapefruit & Guava	Beverages
Alpsnack Bar Apricots & Cranberries	Snacks
Alpsnack Bar Coconut Mango & Pineapple	Snacks
Alpsnack Bar Fair Trade Dark Chocolate	Snacks
Alpsnack Bar Fair Trade Espresso Chocolate	Snacks
Alpsnack Bar Plums & Currants	Snacks
Altoids Chewing Gum Cinnamon	Candy
Altoids Chewing Sugar Free Gum Spearmint	Candy
Altoids Curiously Strong Sours Tangerine Fruit Candy	Candy
Altoids Dark Chocolate Dipped Peppermint Mints	Candy
Altoids Ginger Mints	Candy
Altoids Ginger Tin	Candy
Altoids Liquorice Tin	Candy
Altoids Mango Candy	Candy
Altoids Mango Sours Candy Tin	Candy
Altoids Smalls Cinnamon	Candy
Altoids Smalls Peppermint Mints	Candy
Altoids Smalls Wintergreen	Candy
Altoids Sugar Free Chewing Gum Peppermint	Candy
Altoids Sugar Free Chewing Gum Peppermint	Candy
Amp Energy Drink 4 Pack	Beverages
Andy Capp's Cheddar Fries	Snacks
Andy Capp's Hot Fries	Snacks
Andy Capp's Steak Fries Hot Chili Cheese	Snacks
Annie's Bunny Snack Variety Pack	Snacks
Annie's Chocolate Bunny Grahams	Snacks
Annie's Chocolate Chip Bunny Grahams	Snacks
Annie's Homegrown Organic Snack Mix Bunnies Cheddar	Snacks
Annie's Honey Bunny Grahams	Snacks
Annie's Organic Cheddar Bunnies	Snacks
Annie's Real Cheddar Bunnies	Snacks
AriZona Green Tea Lemonade	Beverages
AriZona Iced Tea With Raspberry Flavor	Beverages
Arizona Rx Energy Herbal Tonic	Beverages
Ass Kickin' Cajun Seasoning From Hell	Cooking Supplies
Ass Kickin' Peanuts With Habanero Pepper	Snacks
Ass Kickin' Seasoning From Hell	Cooking Supplies
Atkins Ready To Drink Shake Cafe Caramel	Beverages
Atkins Ready to Drink Shake Dark Chocolate Royale	Beverages
Atkins Ready To Drink Shake Milk Chocolate Delight	Beverages
Atkins Ready To Drink Shake Strawberry	Beverages
Atkins Ready To Drink Shake Vanilla	Beverages
Award Cuisine Chicken Chow Mein	Frozen Foods
Azar Gold Label Apple Cinnamon Nut Crunch	Snacks
Azar Gold Label Honey Roasted Pecan Halves	Snacks
Azar Gold Label Jumbo Cashews	Snacks
Azar Gold Label Premium Mixed Nuts	Snacks
Azar Gold Label Premium Mixed Nuts Large Jar	Snacks
Azar Gold Label Roasted Jumbo Cashews	Snacks
Azar Gold Label Shelled Pistachios	Snacks
Azar Gold Label Smoked Almonds	Snacks
Azar Nut Co. Mixed Nut Topping with Peanuts	Snacks
Azar Nut Company Almonds Blanched Sliced Raw	Snacks
Azar Nut Company Almonds Diced Oil Roasted	Snacks
Azar Nut Company Almonds Natural Sliced	Snacks
Azar Nut Company Filberts	Snacks
Azar Nut Company Macadamia Nuts Whole Raw	Snacks
Azar Nut Company Mixed Nuts (No Peanuts) Oil Roasted Salted	Snacks
Azar Nut Company Peanuts Roasted Salted	Snacks
Azar Nut Company Pignolias	Snacks
Bacardi Margarita Mix	Beverages
Bacardi Mixers Frozen Mixer Margarita	Beverages
Back To Nature Crispy Cheddar Crackers	Snacks
Back To Nature Fudge Mint Cookies	Snacks
Back To Nature Honey Graham Sticks	Snacks
Back To Nature Madagascar Vanilla Wafers	Snacks
Back To Nature Mini Chocolate Chunk Cookies	Snacks
Baked Cheetos Cheese Snacks Crunchy	Snacks
Baked Lay's Potato Crisps BBQ	Snacks
Baker's Joy No-Stick Spray with Flour	Baking Supplies
Balance Bar Almond Brownie	Snacks
Balance Bar Almond Brownie Box	Snacks
Balance Bar Balance Carb Well Bar Chocolate Peanut Butter	Snacks
Balance Bar Balance Gold Bar Chocolate Mint Cookie Crunch	Snacks
Balance Bar Banana Coconut Box	Snacks
Balance Bar Caramel Nut Blast	Snacks
Balance Bar Caramel Nut Blast Box	Snacks
Balance Bar Chocolate	Snacks
Balance Bar Chocolate Box	Snacks
Balance Bar Chocolate Gold Crunch	Snacks
Diet Pepsi Caffeine Free	Beverages
Diet Pepsi Cola Cans Case	Beverages
Dirty Potato Chips 40% Reduced Fat Potatoe Chips Sea Salt	Snacks
Dirty Potato Chips All Natural Cracked Pepper & Sea Salt	Snacks
Dirty Potato Chips Cracked Pepper & Sea Salt	Snacks
Dirty Potato Chips Funky Fusion	Snacks
Dirty Potato Chips Gourmet Medley	Snacks
Dirty Potato Chips Jalapeno Heat	Snacks
Dirty Potato Chips Maui Onion	Snacks
Dirty Potato Chips Mesquite BBQ	Snacks
Dirty Potato Chips Sea Salt & Vinegar	Snacks
Dirty Potato Chips Sea Salted	Snacks
Dirty Potato Chips Sour Cream & Onion	Snacks
Dolmas Stuffed Grapeleaves	Pantry & Condiments
Doritos Cool Ranch Tortilla Chips	Snacks
Doritos Nacho Cheese Tortilla Chips	Snacks
Doritos Nacho Cheesier Chips Case	Snacks
Doritos Tailgater BBQ	Snacks
Doritos Tortilla Chips Cool Ranch	Snacks
Doritos Tortilla Chips Nacho Cheese	Snacks
Dr. Pepper Cans Case	Beverages
Earth's Best Organic Infant Formula Milk Based With Iron	Baby Food
Earth's Best Organic Infant Formula with Iron	Baby Food
Earths Best Baby Food Organic Soy Infant Formula	Baby Food
EAS 100% Whey Protein Vanilla	Vitamins & Supplements
EAS Myoplex Carb Control Bar Chocolate Peanut Butter	Vitamins & Supplements
EAS Myoplex Lite Bar Peanut Butter Crisp	Vitamins & Supplements
Eden Foods Sea Vegetable Chips	Snacks
Eden Foods Wasabi Powder	Pantry & Condiments
EdenBlend Rice & Soy Beverage	Beverages
Edensoy Organic Soy Milk Vanilla	Beverages
Emerald Berry Blend Premium Trail Mix	Snacks
Emerald Breakfast Blend Premium Trail Mix	Snacks
Emerald Cocoa Roast Almonds	Snacks
Emerald Forest Ricochet Mints Mixed Case	Candy
Emerald Nuts Apple Cinnamon Walnuts 'N Almonds	Snacks
Emerald Nuts Berry Blend	Snacks
Emerald Nuts Breakfast Blend	Snacks
Emerald Nuts Cocktail Peanuts	Snacks
Emerald Nuts Cocktail Peanuts	Snacks
Emerald Nuts Deluxe Mixed Nuts	Snacks
Emerald Nuts Dry Roasted Almonds	Snacks
Emerald Nuts Dry Roasted Almonds	Snacks
Emerald Nuts Dry Roasted Almonds	Snacks
Emerald Nuts Dry Roasted Peanuts	Snacks
Emerald Nuts Dry Roasted Walnuts	Snacks
Emerald Nuts Smoked Almonds	Snacks
Emerald Nuts Tropical Blend	Snacks
Emerald Original Glazed Walnuts	Snacks
Emerald Sea Salt & Pepper Cashew	Snacks
Emerald Tropical Blend Premium Trail Mix	Snacks
Emerald Walnuts N' Almonds-Apple Cinnamon Glazed	Snacks
Endanger Species Chimpanzee Bar Smooth Dark Chocolate	Candy
Endanger Species Chimpanzee Bar Supreme Dark Chocolate	Candy
Endanger Species Manatee Bar Chocolate Rice Crisp	Candy
Endanger Species Tiger Bar Dark Chocolate Espresso	Candy
Endangered Species Bat Bar Intense Dark Chocolate	Candy
Endangered Species Black Panther Bar Dark Chocolate	Candy
Endangered Species Chocolate Smooth Milk Chocolate	Candy
Endangered Species Dark Chocolate Cranberries & Almonds	Candy
Endangered Species Dark Chocolate Hazelnut Toffee	Candy
Endangered Species Dolphin Bar Milk Chocolate With Cherries	Candy
Endangered Species Gorilla Bar Milk Chocolate With Pecan Praline	Candy
Endangered Species Grizzly Bar Dark Chocolate Raspberry	Candy
Endangered Species Organic Dark Chocolate Cherry	Candy
Endangered Species Organic Dark Chocolate Tangerine	Candy
Endangered Species Organic Milk Chocolate Mocha	Candy
Endangered Species Panda Bar Dark & White Chocolate Blend	Candy
Endangered Species Rainforest Bar Dark Chocolate With Forest Mint	Candy
Endangered Species Salmon Bar Smooth Milk Chocolate	Candy
Endangered Species Sea Turtle Bar Dark Chocolate With Blueberries	Candy
Enfagrow Infant Formula Gentlease Powder	Baby Food
Enfagrow Infant Formula Milk-Based With Iron	Baby Food
Enfagrow Infant Formula Vanilla Powder	Baby Food
Enfagrow Toddler Formula Milk-Based Powder Vanilla	Baby Food
Enfamil A.R. Lipil Powder	Baby Food
Enfamil Formula for Toddlers & Infants Soy-Based Powder	Baby Food
Enfamil Infant Formula Hypoallergenic Concentrated Liquid	Baby Food
Enfamil Infant Formula Lipil Milk Based Powder	Baby Food
Enfamil Infant Formula Milk Based Powder	Baby Food
Enfamil Infant Formula Milk Based Powder Can	Baby Food
Enfamil Infant Formula Milk Based Powder Large Can	Baby Food
Enfamil Infant Formula Milk Based Premium Lipil	Baby Food
Enfamil Infant Formula Next Step Lipil Milk Based Powder	Baby Food
Enfamil Infant Formula Nutramigen Lipil Hypoallergenic	Baby Food
Enfamil Infant Formula Premium Lipil Milk-Based	Baby Food
Enfamil Infant Formula Premium Lipil Milk-Based Powder	Baby Food
Enfamil Infant Formula Soy Powder	Baby Food
Enfamil Infant Formula With Iron Milk Based	Baby Food
Enfamil Infant Formula With Iron Milk Based Powder	Baby Food
Enfamil Infant Formula With Iron Milk Based Powder	Baby Food
Enfamil Next Step Lipil	Baby Food
Enfamil Next Step Lipil Formula Powder Iron Fortified	Baby Food
Enfamil Prosobee Infant Formula Soy For Sensitive Tummy	Baby Food
Enjoy Life Boom Choco Boom Crispy Rice Milk Bar	Snacks
Enjoy Life Boom Choco Boom Dark Chocolate Bar	Snacks
Enjoy Life Boom Choco Boom Rice Milk Bar	Snacks
Enjoy Life Caramel Apple Snack Bar	Snacks
Enjoy Life Caramel Apple Snack Bars	Snacks
Enjoy Life Cocoa Loco Snack Bar	Snacks
Kasugai Kiwi And Pineapple Gummy Candies	Candy
Kasugai Kiwi And Strawberry Gummy Candies	Candy
Kasugai Lychee And Apple Gummy Candies	Candy
Kasugai Lychee And Orange Gummy Candies	Candy
Kasugai Lychee And Peach Gummy Candies	Candy
Kasugai Lychee and Strawberry Gummy Candies	Candy
Kay's Naturals Non-Gluten Kruncheeze White Cheddar Cheese	Snacks
Kay's Naturals Pretzel Sticks Cinnamon Toast	Snacks
Kay's Naturals Pretzel Sticks Jalepeno Honey Mustard	Snacks
Kay's Naturals Pretzel Sticks Wasabi	Snacks
Kay's Naturals Protein Chips Crispy Parmesan	Snacks
Keebler Famous Amos Cookies Chocolate Chip	Snacks
Keebler Gripz Chips Deluxe Chocolate Chip Cookies	Snacks
Keebler Gripz Variety Pack	Snacks
Keebler Sugar Free Chocolate Cream Cookies	Snacks
Kellog's Pop Tarts Chocolate Chip Toaster Pastries Master Case	Breakfast
Kellog's Pop Tarts Frosted Apple Strudel Toaster Pastries Master Case	Breakfast
Kellog's Pop Tarts Frosted Cherry Toaster Pastries Master Case	Breakfast
Kellog's Pop Tarts Frosted Chocolate Fudge Toaster Pastries	Breakfast
Kellogg's Fruit & Nut Bars Cranberry Raisin Peanut Grab 'N Go	Snacks
Kellogg's Nutri-Grain Bars Blueberry	Snacks
Kellogg's Nutri-Grain Bars Raspberry	Snacks
Kellogg's Nutri-Grain Bite Size Cereal Bars Strawberry	Snacks
Kellogg's Nutri-Grain Cereal Bars Apple Cinnamon	Snacks
Kellogg's Nutri-Grain Cereal Bars Blueberry	Snacks
Kellogg's Nutri-Grain Cereal Bars Mixed Berry	Snacks
Kellogg's Nutri-Grain Yogurt Bars Strawberry	Snacks
Kellogg's Pop Tarts Blueberry	Breakfast
Kellogg's Pop Tarts Blueberry Muffin	Breakfast
Kellogg's Pop Tarts Chocolate Banana Split	Breakfast
Kellogg's Pop Tarts Chocolate Whole Grain	Breakfast
Kellogg's Pop Tarts Frosted Blueberry Family Pack	Breakfast
Kellogg's Pop Tarts Frosted Brown Sugar Cinnamon	Breakfast
Kellogg's Pop Tarts Frosted Brown Sugar Cinnamon	Breakfast
Kellogg's Pop Tarts Frosted Brown Sugar Cinnamon Family Size	Breakfast
Kellogg's Pop Tarts Frosted Cherry	Breakfast
Kellogg's Pop Tarts Frosted Cherry Family Pack	Breakfast
Kellogg's Pop Tarts Frosted Chocolate Fudge	Breakfast
Kellogg's Pop Tarts Frosted Cookies n' Cream	Breakfast
Kellogg's Pop Tarts Frosted Strawberry	Breakfast
Kellogg's Pop Tarts Frosted Strawberry	Breakfast
Kellogg's Pop Tarts Frosted Strawberry	Breakfast
Kellogg's Pop Tarts S'mores	Breakfast
Kellogg's Pop Tarts Semi-Frosted Chocolate Chip	Breakfast
Kellogg's Pop Tarts Strawberry Family Pack	Breakfast
Kellogg's Pop Tarts Toaster Pastries Variety Pack	Breakfast
Kellogg's Pop Tarts Variety Pack	Breakfast
Kellogg's Pop-Tarts Apple Strudel	Breakfast
Kellogg's Pop-Tarts Brown Sugar Cinnamon	Breakfast
Kellogg's Pop-Tarts Chocolate Chip Cookie Dough	Breakfast
Kellogg's Pop-Tarts Chocolate Vanilla Creme	Breakfast
Kellogg's Pop-Tarts Cinnamon Roll	Breakfast
Kellogg's Pop-Tarts Cookies 'N Cream	Breakfast
Kellogg's Pop-Tarts Frosted Blueberry	Breakfast
Kellogg's Pop-Tarts Frosted Brown Sugar Cinnamon Value Pack	Breakfast
Kellogg's Pop-Tarts Frosted Chocolate Fudge	Breakfast
Kellogg's Pop-Tarts Frosted Chocolate Fudge	Breakfast
Kellogg's Pop-Tarts Frosted Double Berry	Breakfast
Kellogg's Pop-Tarts Frosted Hot Fudge Sundae	Breakfast
Kellogg's Pop-Tarts Frosted Raspberry	Breakfast
Kellogg's Pop-Tarts Frosted Strawberry Family Pack	Breakfast
Kellogg's Pop-Tarts Frosted Strawberry Milkshake	Breakfast
Kellogg's Pop-Tarts Low Fat Frosted Brown Sugar Cinnamon	Breakfast
Kellogg's Pop-Tarts Low Fat Frosted Strawberry	Breakfast
Kellogg's Pop-Tarts Strawberry Cheese Danish	Breakfast
Kellogg's Pop-Tarts Wild! Berry	Breakfast
Kellogg's Rice Krispies Treats Variety Pack	Snacks
Kellogg's Special K Bar Blueberry Grab 'N Go Snacks	Snacks
Kellogg's Special K Bar Strawberry Grab 'N Go Snacks	Snacks
Kellogg's Special K Bars Vanilla Crisp	Snacks
Kellogs Special K Blueberry Bars	Snacks
Kelsen Danish Butter Cookies Tin	Snacks
Ker Cadelac Butter Biscuits From Brittany Galettes De Bretagne	Snacks
Killebrew Root Beer	Beverages
Kirkland Frozen Concentrate Orange Juice	Beverages
Kirkland Infant Formula with Iron	Baby Food
Kirkland Super Extra Large Peanuts	Snacks
KitKat Milk Chocolate Bar King Size	Candy
Kitty Kaviar Cat Treat	Pet Food
Knorr Alfredo Pasta Sauce Mix	Boxed Meals & Sides
Knorr Bearnaise Sauce Mix	Pantry & Condiments
Knorr Demi-Glace Sauce Mix	Pantry & Condiments
Knorr Hollandaise Sauce Mix	Boxed Meals & Sides
Koueidou Japanese Cola Hard Candy	Candy
Kraft Easy Cheese American	Snacks
Kraft Easy Cheese Cheddar	Snacks
Kraft Easy Cheese Cheddar 'N Bacon	Snacks
Kraft Easy Cheese Sharp Cheddar	Snacks
Lang's Chocolates European Style Hot Chocolate Mix	Beverages
Lara Bar Apple Pie	Snacks
Lara Bar Apple Pie Box	Snacks
Lara Bar Banana Cookie Dough	Snacks
Lara Bar Banana Cookie Dough Box	Snacks
Lara Bar Cashew Cookie	Snacks
Lara Bar Cashew Cookie Box	Snacks
Lara Bar Cherry Pie	Snacks
Lara Bar Cherry Pie	Snacks
Lara Bar Cherry Pie Box	Snacks
Lara Bar Cherry Pie Case	Snacks
Lara Bar Chocolate Coconut Chew	Snacks
Lara Bar Chocolate Coconut Chew Box	Snacks
Lara Bar Cocoa Mole	Snacks
Lara Bar Cocoa Mole Box	Snacks
Lara Bar Ginger Snap	Snacks
Lara Bar Ginger Snap Box	Snacks
Larabar Fruit & Nut Food Bar Cinnamon Roll	Snacks
Larabar Fruit & Nut Food Bar Key Lime Pie	Snacks
Larabar Fruit & Nut Food Bar Pecan Pie	Snacks
Larabar Mint Chocolate	Snacks
Lay's Potato Chips Regular Case	Snacks
Lay's Potato Chips Salt & Vinegar	Snacks
Lay's Potato Chips Sour Cream & Onion	Snacks
Le Moulin De Marie Grape Seed Oil	Pantry & Condiments
Le Moulin De Marie Hazelnut Oil	Pantry & Condiments
Le Moulin De Marie Walnut Oil	Pantry & Condiments
LesserEvil Krinkle Sticks Classic Sea Salt	Snacks
Life Savers Tarts Orange Watermelon Cherry Lemonade	Candy
Lifesavers Gummies Sours Theater Box	Candy
Lindt Lindor Chocolate Eggs	Candy
Little Bear Cheddar Puffs	Snacks
Live Energy Drink Acai Berry	Beverages
Live Energy Drink Green Tea	Beverages
Live Energy Drink Sugar Free	Beverages
LoC Maria Crepes au Chocolat Belgian Milk Chocolate Biscuits	Snacks
Lotte Mixed Soda And Cola Japanese Hard Candy	Candy
Lotte Mixed Soda And Cola Japanese Hard Candy	Candy
Luna Bar Berry Almond	Snacks
Luna Bar Caramel Nut Brownie	Snacks
Luna Bar Caramel Nut Brownie	Snacks
Luna Bar Chai Tea	Snacks
Luna Bar Chai Tea Box	Snacks
Luna Bar Cherry Chocolate Box	Snacks
Luna Bar Cherry Covered Chocolate	Snacks
Luna Bar Chocolate Pecan Pie	Snacks
Luna Bar Chocolate Pecan Pie Box	Snacks
Luna Bar Chocolate Peppermint	Snacks
Luna Bar Chocolate Peppermint Box	Snacks
Luna Bar Chocolate Raspberry	Snacks
Luna Bar Cookies 'n Cream Box	Snacks
Luna Bar Cookies 'n Cream Delight	Snacks
Luna Bar Dulce De Leche	Snacks
Luna Bar Iced Oatmeal Box	Snacks
Luna Bar Iced Oatmeal Raisin	Snacks
Luna Bar Key Lime Pie	Snacks
Luna Bar Lemon Zest	Snacks
Luna Bar Lemon Zest Box	Snacks
Luna Bar Nutz Over Chocolate	Snacks
Luna Bar Nutz Over Chocolate Box	Snacks
Luna Bar Orange Bliss	Snacks
Luna Bar Peanut Butter Cookie	Snacks
Luna Bar Peanut Butter Cookie Box	Snacks
Luna Bar S'mores Box	Snacks
Luna Bar Smores	Snacks
Luna Bar Sunrise Vanilla Almond	Snacks
Luna Bar Toasted Nut & Cranberry	Snacks
Luna Bar Toasted Nuts 'n Cranberry	Snacks
Luna Sunrise Bar Strawberry Crumble	Snacks
Luna Sunrise Blueberry Bliss Bar	Snacks
Luna Sunrise Blueberry Yogurt Bar	Snacks
Luna Sunrise Strawberries & Creme Bar	Snacks
Luna Sunrise Vanilla Almond	Snacks
Lundberg Rice Chips Sesame Seaweed	Snacks
Made In Napa Valley Beef & Burger Rub	Cooking Supplies
Madhouse Munchies Blue Corn Tortilla Chips	Snacks
Madhouse Munchies Creamy French Onion Potato Chips	Snacks
Madhouse Munchies Creamy French Onion Potato Chips	Snacks
Madhouse Munchies Creamy French Onion Potato Chips Single Serve	Snacks
Madhouse Munchies Fire Sweet Mesquite BBQ Potato Chips	Snacks
Madhouse Munchies Fire Sweet Mesquite BBQ Potato Chips	Snacks
Madhouse Munchies Fire Sweet Mesquite BBQ Potato Chips	Snacks
Madhouse Munchies Sea Salt & Vinegar Potato Chips	Snacks
Madhouse Munchies Sea Salt & Vinegar Potato Chips	Snacks
Madhouse Munchies Sea Salt & Vinegar Potato Chips	Snacks
Madhouse Munchies Sea Salted Kettle Cooked Potato Chips	Snacks
Madhouse Munchies Sea Salted Potato Chips	Snacks
Madhouse Munchies Sea Salted Potato Chips Single Serve	Snacks
Madhouse Munchies White Corn Tortilla Chips	Snacks
Marcum Gourmet Spices Pure Ground Black Pepper	Cooking Supplies
Mars Bounty Chocolate Bar	Candy
Mauna Loa Dry Roasted Macadamias With Sea Salt	Snacks
Mauna Loa Macadamia Nuts Butter Candy Glazed	Snacks
Mauna Loa Macadamia Nuts Coffee Glazed	Snacks
Mauna Loa Macadamia Nuts Honey Roasted	Snacks
Mauna Loa Macadamia Nuts Maui Onion Garlic	Snacks
Mauna Loa Macadamia Nuts Roasted Unsalted	Snacks
Mauna Loa Milk Chocolate Bar Macadamia Crisp	Candy
Mauna Loa Salted Teriyaki Wasabi Nuts	Snacks
McCormick Black Pepper	Cooking Supplies
McCormick Black Pepper Ground	Cooking Supplies
Mccormick Pure Ground Black Pepper	Cooking Supplies
Mcvitie's Hobnobs Milk Chocolate Tubes	Candy
Mediteranian Organic Grapefruit Sections	Canned Goods
Medora Snacks Corners Sea Salt	Snacks
Melissa's Good Life Food Croutons Garden Herb	Pantry & Condiments
Mexi-Snax Nacho Cheese Tortilla Chips	Snacks
Mexi-Snax Pico De Gallo Chips	Snacks
Mexi-Snax Salsa Picante Tortilla Chips	Snacks
Mexi-Snax Sesame Tortilla Chips	Snacks
Mexi-Snax Tamari Tortilla Chips	Snacks
Mi-Del Gluten Free Chocolate Sandwich Cookie	Snacks

